#,#,#,#,#,#,#,#,#,#,#,#,#,E,#
#,c,c,c,c,c,c,c,c,c,#,c,c,c,#
#,#,#,c,#,c,#,#,#,#,#,c,#,#,#
#,c,c,c,#,c,#,c,c,c,#,c,#,c,#
#,c,#,#,#,c,#,c,#,#,#,c,#,c,#
#,c,#,c,c,c,c,c,#,c,c,c,c,c,#
#,c,#,c,#,#,#,#,#,#,#,c,#,c,#
#,c,#,c,c,c,c,c,c,c,#,c,#,c,#
#,c,#,#,#,c,#,#,#,c,#,#,#,c,#
#,c,c,c,#,c,#,c,#,c,c,c,c,c,#
#,#,#,c,#,#,#,c,#,#,#,#,#,#,#
#,c,#,c,c,c,#,c,#,c,c,c,c,c,#
#,c,#,#,#,c,#,c,#,c,#,#,#,c,#
#,c,c,c,c,c,c,c,c,c,c,c,#,c,S
#,#,#,#,#,#,#,#,#,#,#,#,#,#,#
