W,W,W,W,W,W,W,W,W,W,W,W,W,E,W
W,L,L,L,L,L,L,L,L,L,W,L,L,L,W
W,W,W,L,W,L,W,W,W,W,W,L,W,W,W
W,L,L,L,W,L,W,L,L,L,W,L,W,L,W
W,L,W,W,W,L,W,L,W,W,W,L,W,L,W
W,L,W,L,L,L,L,L,W,L,L,L,L,L,W
W,L,W,L,W,W,W,W,W,W,W,L,W,L,W
W,L,W,L,L,L,L,L,L,L,W,L,W,L,W
W,L,W,W,W,L,W,W,W,L,W,W,W,L,W
W,L,L,L,W,L,W,L,W,L,L,L,L,L,W
W,W,W,L,W,W,W,L,W,W,W,W,W,W,W
W,L,W,L,L,L,W,L,W,L,L,L,L,L,W
W,L,W,W,W,L,W,L,W,L,W,W,W,L,W
W,L,L,L,L,L,L,L,L,L,L,L,W,L,S
W,W,W,W,W,W,W,W,W,W,W,W,W,W,W
