WWWWWWWWWWWWWEW
WLLLLLLLLLWLLLW
WWWLWLWWWWWLWWW
WLLLWLWLLLWLWLW
WLWWWLWLWWWLWLW
WLWLLLLLWLLLLLW
WLWLWWWWWWWLWLW
WLWLLLLLLLWLWLW
WLWWWLWWWLWWWLW
WLLLWLWLWLLLLLW
WWWLWWWLWWWWWWW
WLWLLLWLWLLLLLW
WLWWWLWLWLWWWLW
WLLLLLLLLLLLWLS 
WWWWWWWWWWWWWWW
