MMMMMMMMMMMMMEM
MCCCCCCCCCMCCCM
MMMCMCMMMMMCMMM
MCCCMCMCCCMCMCM
MCMMMCMCMMMCMCM
MCMCCCCCMCCCCCM
MCMCMMMMMMMCMCM
MCMCCCCCCCMCMCM
MCMMMCMMMCMMMCM
MCCCMCMCMCCCCCM
MMMCMMMCMMMMMMM
MCMCCCMCMCCCCCM
MCMMMCMCMCMMMCM
MCCCCCCCCCCCMCS 
MMMMMMMMMMMMMMM