#############E#
#CCCCCCCCC#CCC#
###C#C#####C###
#CCC#C#CCC#C#C#
#C###C#C###C#C#
#C#CCCCC#CCCCC#
#C#C#######C#C#
#C#CCCCCCC#C#C#
#C###C###C###C#
#CCC#C#C#CCCCC#
###C###C#######
#C#CCC#C#CCCCC#
#C###C#C#C###C#
#CCCCCCCCCCC#CS 
###############