#############E#
#ccccccccc#ccc#
###c#c#####c###
#ccc#c#ccc#c#c#
#c###c#c###c#c#
#c#ccccc#ccccc#
#c#c#######c#c#
#c#ccccccc#c#c#
#c###c###c###c#
#ccc#c#c#ccccc#
###c###c#######
#c#ccc#c#ccccc#
#c###c#c#c###c#
#ccccccccccc#cS 
###############