#,#,#,#,#,#,#,#,#,#,#,#,#,E,#
#,C,C,C,C,C,C,C,C,C,#,C,C,C,#
#,#,#,C,#,C,#,#,#,#,#,C,#,#,#
#,C,C,C,#,C,#,C,C,C,#,C,#,C,#
#,C,#,#,#,C,#,C,#,#,#,C,#,C,#
#,C,#,C,C,C,C,C,#,C,C,C,C,C,#
#,C,#,C,#,#,#,#,#,#,#,C,#,C,#
#,C,#,C,C,C,C,C,C,C,#,C,#,C,#
#,C,#,#,#,C,#,#,#,C,#,#,#,C,#
#,C,C,C,#,C,#,C,#,C,C,C,C,C,#
#,#,#,C,#,#,#,C,#,#,#,#,#,#,#
#,C,#,C,C,C,#,C,#,C,C,C,C,C,#
#,C,#,#,#,C,#,C,#,C,#,#,#,C,#
#,C,C,C,C,C,C,C,C,C,C,C,#,C,S
#,#,#,#,#,#,#,#,#,#,#,#,#,#,#
